//MAP CONVERTED BY dmm2tgm.py THIS HEADER COMMENT PREVENTS RECONVERSION, DO NOT REMOVE
"ar" = (
/obj/effect/decal/cleanable/dirt,
/obj/effect/decal/cleanable/dirt,
/obj/effect/decal/cleanable/dirt,
/turf/open/floor/mineral/titanium,
/area/ruin/space/has_grav/powered)
"bm" = (
/obj/effect/decal/cleanable/cobweb/cobweb2,
/turf/open/floor/plasteel,
/area/ruin/space/has_grav/powered)
"bH" = (
/obj/effect/decal/cleanable/dirt,
/obj/machinery/light/small{
	icon_state = "bulb";
	dir = 8
	},
/turf/open/floor/plasteel,
/area/ruin/space/has_grav/powered)
"bW" = (
/obj/structure/chair/sofa/right,
/obj/effect/decal/cleanable/cobweb,
/turf/open/floor/plasteel,
/area/ruin/space/has_grav/powered)
"dq" = (
/obj/structure/table/wood,
/obj/item/reagent_containers/glass/bottle/mutagen{
	name = "Xarope"
	},
/turf/open/floor/plasteel,
/area/ruin/space/has_grav/powered)
"dA" = (
/obj/structure/table/wood,
/obj/item/reagent_containers/food/snacks/store/cake/chocolate,
/turf/open/floor/plasteel,
/area/ruin/space/has_grav/powered)
"fc" = (
/obj/effect/decal/cleanable/cobweb,
/obj/effect/decal/cleanable/dirt,
/turf/open/floor/plasteel,
/area/ruin/space/has_grav/powered)
"gq" = (
/obj/effect/turf_decal/tile/brown,
/obj/effect/turf_decal/tile/brown{
	dir = 8
	},
/obj/item/twohanded/required/kirbyplants/random,
/turf/open/floor/mineral/titanium,
/area/ruin/space/has_grav/powered)
"gF" = (
/obj/machinery/shower{
	dir = 4
	},
/obj/structure/curtain,
/obj/effect/decal/cleanable/dirt,
/turf/open/floor/plasteel/freezer,
/area/ruin/space/has_grav/powered)
"hx" = (
/turf/open/floor/mineral/titanium,
/area/ruin/space/has_grav/powered)
"iP" = (
/obj/structure/chair/wood{
	dir = 1
	},
/turf/open/floor/plasteel,
/area/ruin/space/has_grav/powered)
"jO" = (
/obj/structure/mineral_door/wood,
/obj/effect/decal/cleanable/dirt,
/turf/open/floor/mineral/titanium,
/area/ruin/space/has_grav/powered)
"kp" = (
/obj/structure/table/wood,
/obj/item/kitchen/fork,
/obj/effect/decal/cleanable/dirt,
/obj/effect/decal/cleanable/dirt,
/turf/open/floor/plasteel,
/area/ruin/space/has_grav/powered)
"kG" = (
/obj/structure/fermenting_barrel,
/obj/effect/decal/cleanable/dirt,
/obj/effect/decal/cleanable/dirt,
/turf/open/floor/mineral/titanium,
/area/ruin/space/has_grav/powered)
"mh" = (
/obj/effect/decal/cleanable/dirt,
/obj/effect/decal/cleanable/dirt,
/mob/living/simple_animal/hostile/feral_cat{
	name = "Satan?s"
	},
/turf/open/floor/plasteel,
/area/ruin/space/has_grav/powered)
"of" = (
/obj/effect/decal/cleanable/dirt,
/obj/machinery/light/small{
	icon_state = "bulb";
	dir = 1
	},
/turf/open/floor/mineral/titanium,
/area/ruin/space/has_grav/powered)
"pS" = (
/obj/structure/chair/wood{
	dir = 1
	},
/obj/machinery/light/small,
/turf/open/floor/plasteel,
/area/ruin/space/has_grav/powered)
"qD" = (
/obj/effect/turf_decal/tile/brown{
	dir = 1
	},
/obj/effect/turf_decal/tile/brown{
	dir = 8
	},
/turf/open/floor/mineral/titanium,
/area/ruin/space/has_grav/powered)
"rm" = (
/obj/structure/sink/kitchen{
	dir = 4;
	pixel_x = -11
	},
/turf/open/floor/mineral/titanium,
/area/ruin/space/has_grav/powered)
"rs" = (
/obj/effect/decal/cleanable/dirt,
/turf/closed/wall/mineral/sandstone,
/area/ruin/space/has_grav/powered)
"rK" = (
/obj/effect/decal/cleanable/dirt,
/obj/effect/decal/cleanable/dirt,
/turf/open/floor/plasteel,
/area/ruin/space/has_grav/powered)
"rN" = (
/obj/structure/chair/comfy/brown,
/turf/open/floor/plasteel,
/area/ruin/space/has_grav/powered)
"sr" = (
/obj/effect/spawner/structure/window,
/turf/open/floor/plasteel,
/area/ruin/space/has_grav/powered)
"sy" = (
/obj/effect/turf_decal/tile/brown{
	dir = 4
	},
/obj/effect/turf_decal/tile/brown{
	dir = 1
	},
/turf/open/floor/mineral/titanium,
/area/ruin/space/has_grav/powered)
"sI" = (
/obj/structure/chair/wood{
	dir = 8
	},
/turf/open/floor/plasteel,
/area/ruin/space/has_grav/powered)
"ts" = (
/obj/effect/decal/cleanable/dirt,
/turf/open/floor/mineral/titanium,
/area/ruin/space/has_grav/powered)
"ux" = (
/obj/effect/turf_decal/tile/brown{
	dir = 1
	},
/obj/effect/decal/cleanable/dirt,
/turf/open/floor/mineral/titanium,
/area/ruin/space/has_grav/powered)
"uJ" = (
/obj/effect/decal/cleanable/dirt,
/obj/effect/decal/cleanable/dirt,
/turf/open/floor/plasteel/stairs,
/area/ruin/space/has_grav/powered)
"uQ" = (
/obj/effect/decal/cleanable/dirt,
/obj/effect/decal/cleanable/dirt,
/turf/open/floor/mineral/titanium,
/area/ruin/space/has_grav/powered)
"vx" = (
/obj/effect/turf_decal/tile/brown,
/turf/open/floor/mineral/titanium,
/area/ruin/space/has_grav/powered)
"wC" = (
/obj/structure/chair/wood,
/obj/effect/decal/cleanable/dirt,
/turf/open/floor/plasteel,
/area/ruin/space/has_grav/powered)
"xo" = (
/obj/structure/mineral_door/wood,
/turf/open/floor/plasteel,
/area/ruin/space/has_grav/powered)
"xq" = (
/obj/effect/decal/cleanable/dirt,
/turf/open/floor/mineral/reagent,
/area/ruin/space/has_grav/powered)
"xC" = (
/obj/item/twohanded/required/kirbyplants,
/turf/open/floor/mineral/titanium,
/area/ruin/space/has_grav/powered)
"xH" = (
/obj/machinery/atmospherics/components/unary/tank/air,
/turf/open/floor/mineral/titanium,
/area/ruin/space/has_grav/powered)
"ya" = (
/obj/structure/chair/sofa/right{
	dir = 4
	},
/obj/effect/decal/cleanable/dirt,
/turf/open/floor/plasteel,
/area/ruin/space/has_grav/powered)
"yq" = (
/obj/effect/decal/cleanable/cobweb/cobweb2,
/obj/effect/decal/cleanable/dirt,
/turf/open/floor/plasteel,
/area/ruin/space/has_grav/powered)
"yM" = (
/obj/item/toy/beach_ball,
/obj/effect/decal/cleanable/dirt,
/turf/open/floor/mineral/titanium,
/area/ruin/space/has_grav/powered)
"yW" = (
/obj/item/staff/broom,
/turf/open/floor/plasteel,
/area/ruin/space/has_grav/powered)
"zn" = (
/obj/structure/mineral_door/wood,
/obj/effect/decal/cleanable/dirt,
/obj/structure/fans/tiny,
/turf/open/floor/mineral/titanium,
/area/ruin/space/has_grav/powered)
"zY" = (
/obj/structure/table/wood,
/obj/item/clothing/gloves/boxing/yellow,
/obj/effect/decal/cleanable/dirt,
/turf/open/floor/plasteel,
/area/ruin/space/has_grav/powered)
"Aj" = (
/obj/structure/mineral_door/wood,
/obj/effect/decal/cleanable/dirt,
/turf/open/floor/plasteel,
/area/ruin/space/has_grav/powered)
"AJ" = (
/obj/structure/table/wood,
/obj/machinery/computer/security/wooden_tv,
/turf/open/floor/plasteel,
/area/ruin/space/has_grav/powered)
"AP" = (
/obj/item/clothing/head/foilhat,
/turf/open/floor/plating/beach/water,
/area/ruin/space/has_grav/powered)
"Cx" = (
/turf/open/floor/plating/beach/water,
/area/ruin/space/has_grav/powered)
"Cz" = (
/obj/structure/table/wood,
/obj/item/book/granter/spell/random,
/obj/effect/decal/cleanable/dirt,
/turf/open/floor/plasteel,
/area/ruin/space/has_grav/powered)
"Df" = (
/obj/vehicle/ridden/scooter{
	dir = 4
	},
/turf/open/floor/mineral/titanium,
/area/ruin/space/has_grav/powered)
"Eb" = (
/obj/effect/turf_decal/tile/brown{
	dir = 4
	},
/obj/effect/turf_decal/tile/brown{
	dir = 1
	},
/obj/effect/decal/cleanable/dirt,
/turf/open/floor/mineral/titanium,
/area/ruin/space/has_grav/powered)
"Ec" = (
/obj/effect/decal/cleanable/dirt,
/obj/machinery/light/small,
/turf/open/floor/mineral/titanium,
/area/ruin/space/has_grav/powered)
"Eh" = (
/obj/structure/chair/sofa/left{
	dir = 4
	},
/obj/effect/decal/cleanable/dirt,
/turf/open/floor/plasteel,
/area/ruin/space/has_grav/powered)
"Ev" = (
/obj/structure/table/wood,
/obj/item/clothing/under/sailor,
/obj/effect/decal/cleanable/dirt,
/turf/open/floor/plasteel,
/area/ruin/space/has_grav/powered)
"EL" = (
/obj/machinery/atmospherics/components/unary/tank/air,
/obj/effect/decal/cleanable/dirt,
/turf/open/floor/mineral/titanium,
/area/ruin/space/has_grav/powered)
"EM" = (
/obj/structure/chair/wood{
	dir = 8
	},
/obj/effect/decal/cleanable/dirt,
/turf/open/floor/plasteel,
/area/ruin/space/has_grav/powered)
"EZ" = (
/obj/effect/decal/cleanable/cobweb/cobweb2,
/turf/open/floor/mineral/titanium,
/area/ruin/space/has_grav/powered)
"FL" = (
/obj/structure/lattice,
/turf/open/space/basic,
/area/space)
"GN" = (
/obj/item/toy/figure/clown,
/obj/effect/decal/cleanable/dirt,
/turf/open/floor/mineral/titanium,
/area/ruin/space/has_grav/powered)
"Ic" = (
/obj/effect/turf_decal/tile/brown{
	dir = 4
	},
/obj/effect/turf_decal/tile/brown,
/turf/open/floor/mineral/titanium,
/area/ruin/space/has_grav/powered)
"Ih" = (
/obj/effect/decal/remains/human,
/obj/effect/decal/cleanable/dirt,
/obj/effect/decal/cleanable/dirt,
/obj/structure/mirror/magic/pride{
	pixel_x = -28
	},
/turf/open/floor/plasteel,
/area/ruin/space/has_grav/powered)
"Iy" = (
/obj/structure/table/wood,
/turf/open/floor/plasteel,
/area/ruin/space/has_grav/powered)
"Jk" = (
/obj/structure/bed,
/obj/item/bedsheet/red,
/obj/effect/decal/cleanable/cobweb/cobweb2,
/obj/effect/decal/cleanable/dirt,
/turf/open/floor/plasteel,
/area/ruin/space/has_grav/powered)
"JE" = (
/turf/open/floor/plasteel,
/area/ruin/space/has_grav/powered)
"KH" = (
/obj/effect/turf_decal/tile/brown,
/obj/effect/turf_decal/tile/brown{
	dir = 8
	},
/turf/open/floor/mineral/titanium,
/area/ruin/space/has_grav/powered)
"LI" = (
/obj/effect/decal/cleanable/cobweb/cobweb2,
/obj/item/twohanded/required/kirbyplants/random,
/turf/open/floor/mineral/titanium,
/area/ruin/space/has_grav/powered)
"Mp" = (
/obj/effect/turf_decal/tile/brown{
	dir = 4
	},
/obj/effect/turf_decal/tile/brown,
/obj/effect/decal/cleanable/dirt,
/turf/open/floor/mineral/titanium,
/area/ruin/space/has_grav/powered)
"Mz" = (
/turf/open/space/basic,
/area/space)
"ML" = (
/obj/effect/turf_decal/tile/brown{
	dir = 8
	},
/obj/effect/decal/cleanable/dirt,
/turf/open/floor/mineral/titanium,
/area/ruin/space/has_grav/powered)
"MU" = (
/obj/item/twohanded/required/kirbyplants/random,
/turf/open/floor/mineral/titanium,
/area/ruin/space/has_grav/powered)
"NX" = (
/obj/effect/turf_decal/tile/brown,
/obj/effect/turf_decal/tile/brown{
	dir = 8
	},
/obj/effect/decal/cleanable/dirt,
/turf/open/floor/mineral/titanium,
/area/ruin/space/has_grav/powered)
"Oe" = (
/obj/vehicle/ridden/bicycle{
	dir = 4
	},
/turf/open/floor/mineral/titanium,
/area/ruin/space/has_grav/powered)
"Ot" = (
/obj/structure/table/wood,
/obj/item/reagent_containers/food/snacks/sausage{
	name = "lingui?a"
	},
/obj/effect/decal/cleanable/dirt,
/turf/open/floor/plasteel,
/area/ruin/space/has_grav/powered)
"OO" = (
/obj/structure/toilet{
	dir = 8
	},
/obj/effect/decal/cleanable/dirt,
/turf/open/floor/plasteel/freezer,
/area/ruin/space/has_grav/powered)
"PY" = (
/obj/structure/chair/wood{
	dir = 4
	},
/turf/open/floor/plasteel,
/area/ruin/space/has_grav/powered)
"Qf" = (
/obj/structure/chair/wood{
	dir = 1
	},
/obj/effect/decal/cleanable/dirt,
/turf/open/floor/plasteel,
/area/ruin/space/has_grav/powered)
"Qz" = (
/obj/effect/decal/cleanable/cobweb,
/turf/open/floor/plasteel/stairs,
/area/ruin/space/has_grav/powered)
"RD" = (
/obj/structure/table/wood,
/obj/effect/decal/cleanable/dirt,
/obj/effect/decal/cleanable/dirt,
/obj/effect/decal/cleanable/dirt,
/turf/open/floor/plasteel,
/area/ruin/space/has_grav/powered)
"Sq" = (
/obj/structure/chair/wood,
/turf/open/floor/plasteel,
/area/ruin/space/has_grav/powered)
"SD" = (
/obj/structure/sink{
	dir = 4;
	pixel_x = 11
	},
/obj/structure/mirror{
	pixel_x = 28
	},
/obj/effect/decal/cleanable/cobweb/cobweb2,
/obj/effect/decal/cleanable/dirt,
/turf/open/floor/plasteel/freezer,
/area/ruin/space/has_grav/powered)
"SW" = (
/turf/closed/wall/mineral/sandstone,
/area/ruin/space/has_grav/powered)
"WM" = (
/obj/structure/table/wood,
/obj/item/reagent_containers/food/snacks/cookie,
/turf/open/floor/plasteel,
/area/ruin/space/has_grav/powered)
"Xd" = (
/obj/structure/mineral_door/wood,
/obj/effect/decal/cleanable/dirt,
/turf/open/floor/plasteel/freezer,
/area/ruin/space/has_grav/powered)
"Xn" = (
/obj/structure/table/wood,
/obj/item/kitchen/knife,
/obj/effect/decal/cleanable/dirt,
/obj/effect/decal/cleanable/dirt,
/turf/open/floor/plasteel,
/area/ruin/space/has_grav/powered)
"Xr" = (
/obj/effect/decal/cleanable/dirt,
/obj/machinery/light/small{
	icon_state = "bulb";
	dir = 4
	},
/turf/open/floor/plasteel,
/area/ruin/space/has_grav/powered)
"XF" = (
/obj/effect/decal/cleanable/dirt,
/turf/open/floor/plasteel,
/area/ruin/space/has_grav/powered)
"Zs" = (
/obj/effect/turf_decal/tile/brown{
	dir = 1
	},
/obj/effect/turf_decal/tile/brown{
	dir = 8
	},
/obj/item/twohanded/required/kirbyplants/random,
/turf/open/floor/mineral/titanium,
/area/ruin/space/has_grav/powered)
"ZL" = (
/obj/effect/turf_decal/tile/brown{
	dir = 4
	},
/turf/open/floor/mineral/titanium,
/area/ruin/space/has_grav/powered)
"ZX" = (
/obj/structure/chair/sofa/left,
/turf/open/floor/plasteel,
/area/ruin/space/has_grav/powered)

(1,1,1) = {"
Mz
Mz
Mz
FL
Mz
Mz
FL
SW
SW
SW
SW
SW
SW
zn
zn
SW
SW
SW
FL
Mz
Mz
"}
(2,1,1) = {"
Mz
Mz
FL
FL
FL
FL
FL
SW
SW
SW
SW
SW
SW
hx
uQ
hx
MU
SW
FL
FL
Mz
"}
(3,1,1) = {"
SW
SW
SW
SW
SW
SW
SW
SW
SW
Qz
xq
uJ
hx
hx
ts
hx
ts
SW
FL
Mz
Mz
"}
(4,1,1) = {"
SW
fc
PY
JE
bH
JE
JE
JE
SW
xC
rm
kG
ts
hx
hx
GN
ts
SW
FL
Mz
Mz
"}
(5,1,1) = {"
SW
Sq
Ev
iP
rK
rK
Eh
ya
SW
EL
ts
hx
hx
ts
hx
hx
Ec
SW
FL
FL
Mz
"}
(6,1,1) = {"
SW
Sq
Ot
iP
JE
rN
WM
Iy
sr
xH
ar
ts
ts
yM
ts
hx
hx
SW
Mz
Mz
Mz
"}
(7,1,1) = {"
SW
XF
sI
XF
XF
XF
XF
XF
jO
ts
ts
hx
ts
hx
ts
ts
Oe
SW
FL
Mz
Mz
"}
(8,1,1) = {"
SW
JE
JE
JE
JE
XF
AJ
JE
SW
LI
hx
ts
hx
hx
hx
hx
hx
SW
FL
FL
Mz
"}
(9,1,1) = {"
SW
SW
SW
SW
SW
SW
SW
SW
SW
xo
SW
hx
hx
SW
sr
Aj
SW
SW
SW
SW
SW
"}
(10,1,1) = {"
Mz
FL
FL
SW
fc
JE
JE
JE
XF
JE
SW
ts
uQ
SW
bW
XF
JE
Ih
AJ
Iy
SW
"}
(11,1,1) = {"
Mz
Mz
FL
SW
RD
XF
mh
JE
XF
JE
SW
ts
ts
SW
ZX
XF
JE
XF
PY
XF
SW
"}
(12,1,1) = {"
Mz
Mz
FL
SW
Cz
XF
JE
Iy
Xn
XF
SW
uQ
hx
SW
SW
Aj
SW
wC
Iy
pS
SW
"}
(13,1,1) = {"
Mz
FL
FL
SW
Iy
rK
JE
dA
kp
JE
SW
ts
hx
SW
XF
XF
SW
Sq
zY
Qf
SW
"}
(14,1,1) = {"
Mz
Mz
Mz
SW
yq
XF
Xr
XF
XF
yW
SW
ts
ts
sr
Jk
dq
SW
bm
EM
JE
SW
"}
(15,1,1) = {"
Mz
Mz
Mz
SW
SW
SW
SW
SW
SW
SW
SW
ts
hx
SW
SW
SW
SW
Xd
SW
SW
SW
"}
(16,1,1) = {"
Mz
Mz
Mz
Mz
Mz
FL
FL
FL
Mz
Mz
SW
hx
hx
hx
hx
SW
SD
OO
gF
SW
Mz
"}
(17,1,1) = {"
Mz
Mz
Mz
Mz
Mz
FL
Mz
Mz
Mz
FL
SW
hx
ts
hx
ts
SW
SW
SW
SW
SW
FL
"}
(18,1,1) = {"
Mz
Mz
Mz
Mz
Mz
Mz
Mz
Mz
Mz
Mz
SW
hx
uQ
hx
hx
hx
hx
hx
SW
FL
FL
"}
(19,1,1) = {"
Mz
Mz
Mz
Mz
Mz
Mz
Mz
Mz
Mz
FL
SW
of
vx
Ic
Mp
Mp
ZL
ts
SW
FL
Mz
"}
(20,1,1) = {"
Mz
Mz
Mz
Mz
Mz
Mz
Mz
Mz
Mz
Mz
SW
ts
NX
Cx
Cx
Cx
Eb
ts
SW
FL
Mz
"}
(21,1,1) = {"
Mz
Mz
Mz
Mz
Mz
Mz
Mz
Mz
Mz
FL
SW
hx
gq
Cx
AP
Cx
sy
hx
SW
FL
Mz
"}
(22,1,1) = {"
Mz
Mz
Mz
Mz
Mz
Mz
Mz
Mz
Mz
FL
SW
ts
KH
Cx
Cx
Cx
sy
hx
SW
FL
Mz
"}
(23,1,1) = {"
Mz
Mz
Mz
Mz
Mz
Mz
Mz
Mz
Mz
Mz
SW
hx
ML
qD
Zs
qD
ux
Df
rs
FL
FL
"}
(24,1,1) = {"
Mz
Mz
Mz
Mz
Mz
Mz
Mz
Mz
Mz
FL
SW
EZ
hx
hx
ts
hx
ts
hx
SW
FL
Mz
"}
(25,1,1) = {"
Mz
Mz
Mz
Mz
Mz
Mz
Mz
Mz
FL
FL
SW
SW
SW
SW
SW
SW
SW
SW
SW
FL
Mz
"}
(26,1,1) = {"
Mz
Mz
Mz
Mz
Mz
Mz
Mz
Mz
Mz
Mz
FL
Mz
Mz
FL
Mz
FL
FL
FL
Mz
FL
Mz
"}
