//MAP CONVERTED BY dmm2tgm.py THIS HEADER COMMENT PREVENTS RECONVERSION, DO NOT REMOVE
"ar" = (
/obj/effect/decal/cleanable/dirt,
/obj/effect/decal/cleanable/dirt,
/obj/effect/decal/cleanable/dirt,
/turf/open/floor/mineral/titanium,
/area/ruin/space/has_grav)
"bm" = (
/obj/effect/decal/cleanable/cobweb/cobweb2,
/turf/open/floor/plasteel,
/area/ruin/space/has_grav/powered)
"bQ" = (
/obj/machinery/light{
	dir = 8
	},
/turf/open/floor/plasteel,
/area/ruin/space/has_grav/powered)
"bW" = (
/obj/structure/chair/sofa/right,
/obj/effect/decal/cleanable/cobweb,
/turf/open/floor/plasteel,
/area/ruin/space/has_grav/powered)
"dq" = (
/obj/structure/table/wood,
/obj/item/reagent_containers/glass/bottle/mutagen{
	name = "Xarope"
	},
/turf/open/floor/plasteel,
/area/ruin/space/has_grav/powered)
"dA" = (
/obj/structure/table/wood,
/obj/item/reagent_containers/food/snacks/store/cake/chocolate,
/turf/open/floor/plasteel,
/area/ruin/space/has_grav/powered)
"eO" = (
/obj/effect/decal/cleanable/dirt,
/obj/structure/mineral_door/wood{
	name = "Vila do Chaves"
	},
/obj/structure/fans/tiny,
/turf/open/floor/mineral/titanium,
/area/ruin/space/has_grav)
"fc" = (
/obj/effect/decal/cleanable/cobweb,
/obj/effect/decal/cleanable/dirt,
/turf/open/floor/plasteel,
/area/ruin/space/has_grav/powered)
"fo" = (
/obj/effect/decal/cleanable/dirt,
/obj/effect/decal/cleanable/dirt,
/turf/open/floor/mineral/titanium,
/area/ruin/space/has_grav)
"fw" = (
/obj/effect/turf_decal/tile/brown{
	dir = 8
	},
/obj/effect/turf_decal/tile/brown{
	dir = 1
	},
/turf/open/floor/mineral/titanium,
/area/ruin/space/has_grav)
"gF" = (
/obj/machinery/shower{
	dir = 4
	},
/obj/structure/curtain,
/obj/effect/decal/cleanable/dirt,
/turf/open/floor/plasteel/freezer,
/area/ruin/space/has_grav/powered)
"hx" = (
/turf/open/floor/mineral/titanium,
/area/ruin/space/has_grav)
"iP" = (
/obj/structure/chair/wood{
	dir = 1
	},
/turf/open/floor/plasteel,
/area/ruin/space/has_grav/powered)
"iY" = (
/obj/effect/decal/cleanable/dirt,
/obj/machinery/light{
	dir = 1
	},
/turf/open/floor/mineral/titanium,
/area/ruin/space/has_grav)
"jO" = (
/obj/structure/mineral_door/wood{
	name = "14"
	},
/obj/effect/decal/cleanable/dirt,
/turf/open/floor/mineral/titanium,
/area/ruin/space/has_grav/powered)
"kp" = (
/obj/structure/table/wood,
/obj/item/kitchen/fork,
/obj/effect/decal/cleanable/dirt,
/obj/effect/decal/cleanable/dirt,
/turf/open/floor/plasteel,
/area/ruin/space/has_grav/powered)
"kG" = (
/obj/structure/fermenting_barrel,
/obj/effect/decal/cleanable/dirt,
/obj/effect/decal/cleanable/dirt,
/turf/open/floor/mineral/titanium,
/area/ruin/space/has_grav)
"mh" = (
/mob/living/simple_animal/hostile/feral_cat{
	name = "Satanas"
	},
/obj/effect/decal/cleanable/dirt,
/obj/effect/decal/cleanable/dirt,
/turf/open/floor/plasteel,
/area/ruin/space/has_grav/powered)
"oa" = (
/obj/structure/mineral_door/wood{
	name = "Vila do Chaves"
	},
/obj/effect/decal/cleanable/dirt,
/obj/structure/fans/tiny,
/turf/open/floor/mineral/titanium,
/area/ruin/space/has_grav)
"oi" = (
/obj/effect/turf_decal/tile/brown{
	dir = 1
	},
/turf/open/floor/mineral/titanium,
/area/ruin/space/has_grav)
"qX" = (
/obj/machinery/light{
	dir = 8
	},
/turf/open/floor/mineral/titanium,
/area/ruin/space/has_grav)
"rm" = (
/obj/structure/sink/kitchen{
	dir = 4;
	pixel_x = -11
	},
/turf/open/floor/mineral/titanium,
/area/ruin/space/has_grav)
"rs" = (
/obj/effect/decal/cleanable/dirt,
/turf/closed/wall/mineral/sandstone,
/area/ruin/space/has_grav)
"rK" = (
/obj/effect/decal/cleanable/dirt,
/obj/effect/decal/cleanable/dirt,
/turf/open/floor/plasteel,
/area/ruin/space/has_grav/powered)
"rN" = (
/obj/structure/chair/comfy/brown,
/turf/open/floor/plasteel,
/area/ruin/space/has_grav/powered)
"sr" = (
/obj/effect/spawner/structure/window,
/turf/open/floor/plasteel,
/area/ruin/space/has_grav/powered)
"sy" = (
/obj/effect/turf_decal/tile/brown{
	dir = 4
	},
/obj/effect/turf_decal/tile/brown{
	dir = 1
	},
/obj/effect/decal/cleanable/dirt,
/turf/open/floor/mineral/titanium,
/area/ruin/space/has_grav)
"sI" = (
/obj/structure/chair/wood{
	dir = 8
	},
/turf/open/floor/plasteel,
/area/ruin/space/has_grav/powered)
"to" = (
/obj/structure/mineral_door/wood,
/obj/effect/decal/cleanable/dirt,
/turf/open/floor/plasteel,
/area/ruin/space/has_grav/powered)
"ts" = (
/obj/effect/decal/cleanable/dirt,
/turf/open/floor/mineral/titanium,
/area/ruin/space/has_grav)
"tt" = (
/obj/machinery/light,
/turf/open/floor/mineral/titanium,
/area/ruin/space/has_grav)
"uJ" = (
/obj/effect/decal/cleanable/dirt,
/obj/effect/decal/cleanable/dirt,
/turf/open/floor/plasteel/stairs,
/area/ruin/space/has_grav)
"uM" = (
/obj/effect/decal/cleanable/dirt,
/obj/machinery/light{
	dir = 4
	},
/turf/open/floor/plasteel,
/area/ruin/space/has_grav/powered)
"uQ" = (
/obj/effect/decal/cleanable/dirt,
/obj/effect/decal/cleanable/dirt,
/obj/machinery/light{
	dir = 1
	},
/turf/open/floor/mineral/titanium,
/area/ruin/space/has_grav)
"wC" = (
/obj/structure/chair/wood,
/obj/effect/decal/cleanable/dirt,
/turf/open/floor/plasteel,
/area/ruin/space/has_grav/powered)
"wL" = (
/obj/effect/turf_decal/tile/brown{
	dir = 8
	},
/obj/effect/turf_decal/tile/brown{
	dir = 1
	},
/obj/effect/decal/cleanable/dirt,
/turf/open/floor/mineral/titanium,
/area/ruin/space/has_grav)
"xo" = (
/obj/structure/mineral_door/wood{
	name = "71"
	},
/turf/open/floor/plasteel,
/area/ruin/space/has_grav/powered)
"xq" = (
/obj/effect/decal/cleanable/dirt,
/turf/open/floor/mineral/reagent,
/area/ruin/space/has_grav)
"xC" = (
/obj/item/twohanded/required/kirbyplants,
/turf/open/floor/mineral/titanium,
/area/ruin/space/has_grav)
"xH" = (
/obj/machinery/atmospherics/components/unary/tank/air,
/turf/open/floor/mineral/titanium,
/area/ruin/space/has_grav)
"ya" = (
/obj/structure/chair/sofa/right{
	dir = 4
	},
/obj/effect/decal/cleanable/dirt,
/turf/open/floor/plasteel,
/area/ruin/space/has_grav/powered)
"yq" = (
/obj/effect/decal/cleanable/cobweb/cobweb2,
/obj/effect/decal/cleanable/dirt,
/turf/open/floor/plasteel,
/area/ruin/space/has_grav/powered)
"yM" = (
/obj/item/toy/beach_ball,
/obj/effect/decal/cleanable/dirt,
/turf/open/floor/mineral/titanium,
/area/ruin/space/has_grav)
"yW" = (
/obj/item/staff/broom,
/turf/open/floor/plasteel,
/area/ruin/space/has_grav/powered)
"zY" = (
/obj/structure/table/wood,
/obj/item/clothing/gloves/boxing/yellow,
/obj/effect/decal/cleanable/dirt,
/turf/open/floor/plasteel,
/area/ruin/space/has_grav/powered)
"Aj" = (
/obj/structure/mineral_door/wood{
	name = "72"
	},
/obj/effect/decal/cleanable/dirt,
/turf/open/floor/plasteel,
/area/ruin/space/has_grav/powered)
"Am" = (
/obj/effect/turf_decal/tile/brown{
	dir = 4
	},
/obj/effect/turf_decal/tile/brown,
/obj/effect/decal/cleanable/dirt,
/turf/open/floor/mineral/titanium,
/area/ruin/space/has_grav)
"AJ" = (
/obj/structure/table/wood,
/obj/machinery/computer/security/wooden_tv,
/turf/open/floor/plasteel,
/area/ruin/space/has_grav/powered)
"AP" = (
/obj/item/clothing/head/foilhat,
/turf/open/floor/plating/beach/water,
/area/ruin/space/has_grav)
"Cx" = (
/obj/effect/turf_decal/tile/brown{
	dir = 8
	},
/obj/effect/turf_decal/tile/brown,
/turf/open/floor/mineral/titanium,
/area/ruin/space/has_grav)
"Cz" = (
/obj/structure/table/wood,
/obj/item/book/granter/spell/random,
/obj/effect/decal/cleanable/dirt,
/turf/open/floor/plasteel,
/area/ruin/space/has_grav/powered)
"Df" = (
/obj/vehicle/ridden/scooter{
	dir = 4
	},
/turf/open/floor/mineral/titanium,
/area/ruin/space/has_grav)
"Eb" = (
/obj/effect/turf_decal/tile/brown{
	dir = 4
	},
/obj/effect/turf_decal/tile/brown{
	dir = 1
	},
/turf/open/floor/mineral/titanium,
/area/ruin/space/has_grav)
"Eh" = (
/obj/structure/chair/sofa/left{
	dir = 4
	},
/obj/effect/decal/cleanable/dirt,
/turf/open/floor/plasteel,
/area/ruin/space/has_grav/powered)
"Ev" = (
/obj/structure/table/wood,
/obj/item/clothing/under/sailor,
/obj/effect/decal/cleanable/dirt,
/turf/open/floor/plasteel,
/area/ruin/space/has_grav/powered)
"EL" = (
/obj/machinery/atmospherics/components/unary/tank/air,
/obj/effect/decal/cleanable/dirt,
/turf/open/floor/mineral/titanium,
/area/ruin/space/has_grav)
"EM" = (
/obj/structure/chair/wood{
	dir = 8
	},
/obj/effect/decal/cleanable/dirt,
/turf/open/floor/plasteel,
/area/ruin/space/has_grav/powered)
"EZ" = (
/obj/effect/decal/cleanable/cobweb/cobweb2,
/turf/open/floor/mineral/titanium,
/area/ruin/space/has_grav)
"FA" = (
/turf/closed/wall/mineral/sandstone,
/area/ruin/space/has_grav)
"FL" = (
/obj/structure/lattice,
/turf/open/space/basic,
/area/space/nearstation)
"Gy" = (
/turf/open/floor/plating/beach/water,
/area/ruin/space/has_grav)
"GN" = (
/obj/item/toy/figure/clown,
/obj/effect/decal/cleanable/dirt,
/turf/open/floor/mineral/titanium,
/area/ruin/space/has_grav)
"Ic" = (
/obj/effect/turf_decal/tile/brown,
/obj/effect/decal/cleanable/dirt,
/turf/open/floor/mineral/titanium,
/area/ruin/space/has_grav)
"Ih" = (
/obj/effect/decal/remains/human,
/obj/effect/decal/cleanable/dirt,
/obj/effect/decal/cleanable/dirt,
/obj/structure/mirror/magic/pride{
	pixel_x = -28
	},
/turf/open/floor/plasteel,
/area/ruin/space/has_grav/powered)
"Iy" = (
/obj/structure/table/wood,
/turf/open/floor/plasteel,
/area/ruin/space/has_grav/powered)
"Jk" = (
/obj/structure/bed,
/obj/item/bedsheet/red,
/obj/effect/decal/cleanable/cobweb/cobweb2,
/obj/effect/decal/cleanable/dirt,
/turf/open/floor/plasteel,
/area/ruin/space/has_grav/powered)
"JE" = (
/turf/open/floor/plasteel,
/area/ruin/space/has_grav/powered)
"KW" = (
/obj/effect/decal/cleanable/dirt,
/obj/item/gps{
	name = "Vila do Chaves"
	},
/turf/open/floor/mineral/titanium,
/area/ruin/space/has_grav)
"LI" = (
/obj/effect/decal/cleanable/cobweb/cobweb2,
/obj/item/twohanded/required/kirbyplants/random,
/turf/open/floor/mineral/titanium,
/area/ruin/space/has_grav)
"Mp" = (
/obj/effect/turf_decal/tile/brown{
	dir = 4
	},
/obj/effect/turf_decal/tile/brown,
/turf/open/floor/mineral/titanium,
/area/ruin/space/has_grav)
"Mz" = (
/turf/open/space/basic,
/area/space)
"MU" = (
/obj/item/twohanded/required/kirbyplants/random,
/turf/open/floor/mineral/titanium,
/area/ruin/space/has_grav)
"NB" = (
/obj/effect/turf_decal/tile/brown{
	dir = 8
	},
/turf/open/floor/mineral/titanium,
/area/ruin/space/has_grav)
"Oe" = (
/obj/vehicle/ridden/bicycle{
	dir = 4
	},
/turf/open/floor/mineral/titanium,
/area/ruin/space/has_grav)
"Ot" = (
/obj/structure/table/wood,
/obj/item/reagent_containers/food/snacks/sausage,
/obj/effect/decal/cleanable/dirt,
/turf/open/floor/plasteel,
/area/ruin/space/has_grav/powered)
"OO" = (
/obj/structure/toilet{
	dir = 8
	},
/obj/effect/decal/cleanable/dirt,
/turf/open/floor/plasteel/freezer,
/area/ruin/space/has_grav/powered)
"PS" = (
/obj/effect/decal/cleanable/dirt,
/obj/machinery/light/small{
	dir = 8
	},
/turf/open/floor/plasteel,
/area/ruin/space/has_grav/powered)
"PY" = (
/obj/structure/chair/wood{
	dir = 4
	},
/turf/open/floor/plasteel,
/area/ruin/space/has_grav/powered)
"Qf" = (
/obj/structure/chair/wood{
	dir = 1
	},
/obj/effect/decal/cleanable/dirt,
/obj/machinery/light,
/turf/open/floor/plasteel,
/area/ruin/space/has_grav/powered)
"Qz" = (
/obj/effect/decal/cleanable/cobweb,
/turf/open/floor/plasteel/stairs,
/area/ruin/space/has_grav)
"RD" = (
/obj/structure/table/wood,
/obj/effect/decal/cleanable/dirt,
/obj/effect/decal/cleanable/dirt,
/obj/effect/decal/cleanable/dirt,
/turf/open/floor/plasteel,
/area/ruin/space/has_grav/powered)
"Sq" = (
/obj/structure/chair/wood,
/turf/open/floor/plasteel,
/area/ruin/space/has_grav/powered)
"SD" = (
/obj/structure/sink{
	dir = 4;
	pixel_x = 11
	},
/obj/structure/mirror{
	pixel_x = 28
	},
/obj/effect/decal/cleanable/cobweb/cobweb2,
/obj/effect/decal/cleanable/dirt,
/obj/machinery/light/small{
	dir = 1
	},
/turf/open/floor/plasteel/freezer,
/area/ruin/space/has_grav/powered)
"SW" = (
/turf/closed/wall/mineral/sandstone,
/area/ruin/space/has_grav/powered)
"Uw" = (
/obj/machinery/light{
	dir = 4
	},
/turf/open/floor/mineral/titanium,
/area/ruin/space/has_grav)
"WM" = (
/obj/structure/table/wood,
/obj/item/reagent_containers/food/snacks/cookie,
/turf/open/floor/plasteel,
/area/ruin/space/has_grav/powered)
"Xd" = (
/obj/structure/mineral_door/wood,
/obj/effect/decal/cleanable/dirt,
/turf/open/floor/plasteel/freezer,
/area/ruin/space/has_grav/powered)
"Xn" = (
/obj/structure/table/wood,
/obj/item/kitchen/knife,
/obj/effect/decal/cleanable/dirt,
/obj/effect/decal/cleanable/dirt,
/turf/open/floor/plasteel,
/area/ruin/space/has_grav/powered)
"XF" = (
/obj/effect/decal/cleanable/dirt,
/turf/open/floor/plasteel,
/area/ruin/space/has_grav/powered)
"ZL" = (
/obj/effect/turf_decal/tile/brown{
	dir = 4
	},
/turf/open/floor/mineral/titanium,
/area/ruin/space/has_grav)
"ZX" = (
/obj/structure/chair/sofa/left,
/turf/open/floor/plasteel,
/area/ruin/space/has_grav/powered)

(1,1,1) = {"
Mz
Mz
Mz
FL
Mz
Mz
FL
FA
FA
FA
FA
FA
FA
oa
eO
FA
FA
FA
FL
Mz
Mz
"}
(2,1,1) = {"
Mz
Mz
FL
FL
FL
FL
FL
FA
FA
FA
FA
FA
FA
hx
fo
hx
MU
FA
FL
FL
Mz
"}
(3,1,1) = {"
SW
SW
SW
SW
SW
SW
SW
SW
SW
Qz
xq
uJ
qX
hx
ts
hx
ts
FA
FL
Mz
Mz
"}
(4,1,1) = {"
SW
fc
PY
bQ
XF
JE
JE
JE
SW
xC
rm
kG
ts
hx
hx
GN
ts
FA
FL
Mz
Mz
"}
(5,1,1) = {"
SW
Sq
Ev
iP
rK
rK
Eh
ya
SW
EL
ts
hx
hx
ts
hx
hx
ts
FA
FL
FL
Mz
"}
(6,1,1) = {"
SW
Sq
Ot
iP
JE
rN
WM
Iy
sr
xH
ar
ts
KW
yM
ts
hx
tt
FA
Mz
Mz
Mz
"}
(7,1,1) = {"
SW
XF
sI
XF
XF
XF
XF
XF
jO
ts
ts
hx
ts
hx
ts
ts
Oe
FA
FL
Mz
Mz
"}
(8,1,1) = {"
SW
JE
JE
JE
JE
uM
AJ
JE
SW
LI
hx
ts
hx
hx
hx
hx
MU
FA
FL
FL
Mz
"}
(9,1,1) = {"
SW
SW
SW
SW
SW
SW
SW
SW
SW
xo
SW
hx
hx
SW
sr
Aj
SW
SW
SW
SW
SW
"}
(10,1,1) = {"
Mz
FL
FL
SW
fc
bQ
JE
JE
XF
JE
SW
ts
fo
SW
bW
XF
bQ
Ih
AJ
Iy
SW
"}
(11,1,1) = {"
Mz
Mz
FL
SW
RD
XF
mh
JE
XF
JE
SW
ts
ts
SW
ZX
XF
JE
XF
PY
XF
SW
"}
(12,1,1) = {"
Mz
Mz
FL
SW
Cz
XF
JE
Iy
Xn
XF
SW
uQ
hx
SW
SW
to
SW
wC
Iy
iP
SW
"}
(13,1,1) = {"
Mz
FL
FL
SW
Iy
rK
JE
dA
kp
JE
SW
ts
hx
SW
PS
XF
SW
Sq
zY
Qf
SW
"}
(14,1,1) = {"
Mz
Mz
Mz
SW
yq
XF
XF
XF
XF
yW
SW
ts
ts
sr
Jk
dq
SW
bm
EM
JE
SW
"}
(15,1,1) = {"
Mz
Mz
Mz
SW
SW
SW
SW
SW
SW
SW
SW
ts
hx
SW
SW
SW
SW
Xd
SW
SW
SW
"}
(16,1,1) = {"
Mz
Mz
Mz
Mz
Mz
FL
FL
FL
Mz
Mz
FA
hx
hx
hx
hx
SW
SD
OO
gF
SW
Mz
"}
(17,1,1) = {"
Mz
Mz
Mz
Mz
Mz
FL
Mz
Mz
Mz
FL
FA
hx
ts
hx
ts
SW
SW
SW
SW
SW
FL
"}
(18,1,1) = {"
Mz
Mz
Mz
Mz
Mz
Mz
Mz
Mz
Mz
Mz
FA
hx
fo
hx
hx
hx
qX
hx
FA
FL
FL
"}
(19,1,1) = {"
Mz
Mz
Mz
Mz
Mz
Mz
Mz
Mz
Mz
FL
FA
ts
hx
Ic
Mp
Am
ZL
ts
FA
FL
Mz
"}
(20,1,1) = {"
Mz
Mz
Mz
Mz
Mz
Mz
Mz
Mz
Mz
Mz
FA
iY
hx
Cx
Gy
Gy
Eb
ts
FA
FL
Mz
"}
(21,1,1) = {"
Mz
Mz
Mz
Mz
Mz
Mz
Mz
Mz
Mz
FL
FA
hx
ts
Cx
AP
Gy
sy
hx
FA
FL
Mz
"}
(22,1,1) = {"
Mz
Mz
Mz
Mz
Mz
Mz
Mz
Mz
Mz
FL
FA
ts
hx
NB
wL
fw
oi
hx
FA
FL
Mz
"}
(23,1,1) = {"
Mz
Mz
Mz
Mz
Mz
Mz
Mz
Mz
Mz
Mz
FA
hx
ts
hx
hx
ts
hx
Df
rs
FL
FL
"}
(24,1,1) = {"
Mz
Mz
Mz
Mz
Mz
Mz
Mz
Mz
Mz
FL
FA
EZ
hx
hx
ts
Uw
ts
hx
FA
FL
Mz
"}
(25,1,1) = {"
Mz
Mz
Mz
Mz
Mz
Mz
Mz
Mz
FL
FL
FA
FA
FA
FA
FA
FA
FA
FA
FA
FL
Mz
"}
(26,1,1) = {"
Mz
Mz
Mz
Mz
Mz
Mz
Mz
Mz
Mz
Mz
FL
Mz
Mz
FL
Mz
FL
FL
FL
Mz
FL
Mz
"}
